0000000000000000000000000000
0000000000000000000000000000
0000000000000000000000000000
1111111111111111111111111111
1*________________________*1
1_111__________________111_1
1_1r1__________________1b1_1
1_________1_111_1_1_1______1
1_____11111_1s1_1_1_1______1
1___________1*1_1_1_1______1
1_____11111_1_1_1_1_1______1
1_______1_1__p__1_1_1______1
1_______1_1111111_111______1
1_111__________________111_1
1_1_1__________________1o1_1
1*________________________*1
1111111111111111111111111111
0000000000000000000000000000
0000000000000000000000000000
0000000000000000000000000000